1111111111111111111
10010000000C000C001
1000011111111111001
10P011E000000000001
1111111111111111111